Sample	Group
BrM1	Brain Metastasis
BrM2	Brain Metastasis
BrM3	Brain Metastasis
BrM4	Brain Metastasis
BrM5	Brain Metastasis
BrM6	Brain Metastasis
BrM7	Brain Metastasis
BrM8	Brain Metastasis
BrM9	Brain Metastasis
BrM10	Brain Metastasis
LT1	Lung Primary Tumor
LT2	Lung Primary Tumor
LT3	Lung Primary Tumor
LT4	Lung Primary Tumor
LT5	Lung Primary Tumor
LT6	Lung Primary Tumor
LT7	Lung Primary Tumor
LT8	Lung Primary Tumor
LT9	Lung Primary Tumor
LT10	Lung Primary Tumor
